{
  "levels": [
    {
      "levelName": "Level_1",
      "width": 8,
      "height": 8,
      "startPosA": { "x": 1, "y": 1 },
      "startPosB": { "x": 6, "y": 1 },
      "finishPosA": { "x": 6, "y": 6 },
      "finishPosB": { "x": 1, "y": 6 },
      "enemyPositionsA": [],
      "enemyPositionsB": [],
      "mazeLayoutA": [
        1, 1, 1, 1, 1, 1, 1, 1,
        1, 0, 0, 0, 0, 0, 0, 1,
        1, 0, 0, 0, 0, 0, 0, 1,
        1, 0, 0, 1, 1, 0, 0, 1,
        1, 0, 0, 1, 1, 0, 0, 1,
        1, 0, 0, 0, 0, 0, 0, 1,
        1, 0, 0, 0, 0, 0, 0, 1,
        1, 1, 1, 1, 1, 1, 1, 1
      ],
      "mazeLayoutB": [
        1, 1, 1, 1, 1, 1, 1, 1,
        1, 0, 0, 0, 0, 0, 0, 1,
        1, 0, 0, 0, 0, 0, 0, 1,
        1, 0, 0, 1, 1, 0, 0, 1,
        1, 0, 0, 1, 1, 0, 0, 1,
        1, 0, 0, 0, 0, 0, 0, 1,
        1, 0, 0, 0, 0, 0, 0, 1,
        1, 1, 1, 1, 1, 1, 1, 1
      ]
    },
    {
      "levelName": "Level_2",
      "width": 8,
      "height": 8,
      "startPosA": { "x": 1, "y": 6 },
      "startPosB": { "x": 6, "y": 1 },
      "finishPosA": { "x": 6, "y": 1 },
      "finishPosB": { "x": 1, "y": 6 },
      "enemyPositionsA": [],
      "enemyPositionsB": [],
      "mazeLayoutA": [
        1, 1, 1, 1, 1, 1, 1, 1,
        1, 0, 0, 1, 0, 0, 0, 1,
        1, 0, 0, 1, 0, 0, 0, 1,
        1, 0, 0, 0, 0, 1, 0, 1,
        1, 0, 1, 0, 0, 1, 0, 1,
        1, 0, 1, 0, 0, 1, 0, 1,
        1, 0, 0, 0, 0, 0, 0, 1,
        1, 1, 1, 1, 1, 1, 1, 1
      ],
      "mazeLayoutB": [
        1, 1, 1, 1, 1, 1, 1, 1,
        1, 0, 0, 0, 0, 0, 0, 1,
        1, 0, 1, 0, 0, 1, 0, 1,
        1, 0, 1, 0, 0, 1, 0, 1,
        1, 0, 1, 0, 0, 0, 0, 1,
        1, 0, 0, 0, 1, 0, 0, 1,
        1, 0, 0, 0, 1, 0, 0, 1,
        1, 1, 1, 1, 1, 1, 1, 1
      ]
    },
    {
      "levelName": "Level_3",
      "width": 9,
      "height": 9,
      "startPosA": { "x": 1, "y": 1 },
      "startPosB": { "x": 7, "y": 7 },
      "finishPosA": { "x": 7, "y": 7 },
      "finishPosB": { "x": 1, "y": 1 },
      "enemyPositionsA": [ { "x": 4, "y": 4 } ],
      "enemyPositionsB": [],
      "mazeLayoutA": [
        1, 1, 1, 1, 1, 1, 1, 1, 1,
        1, 0, 0, 0, 0, 0, 0, 0, 1,
        1, 0, 1, 1, 0, 1, 1, 0, 1,
        1, 0, 1, 0, 0, 0, 1, 0, 1,
        1, 0, 0, 0, 0, 0, 0, 0, 1,
        1, 0, 1, 0, 0, 0, 1, 0, 1,
        1, 0, 1, 1, 0, 1, 1, 0, 1,
        1, 0, 0, 0, 0, 0, 0, 0, 1,
        1, 1, 1, 1, 1, 1, 1, 1, 1
      ],
      "mazeLayoutB": [
        1, 1, 1, 1, 1, 1, 1, 1, 1,
        1, 0, 0, 0, 1, 0, 0, 0, 1,
        1, 0, 1, 0, 1, 0, 1, 0, 1,
        1, 0, 0, 0, 0, 0, 0, 0, 1,
        1, 1, 1, 0, 1, 0, 1, 1, 1,
        1, 0, 0, 0, 0, 0, 0, 0, 1,
        1, 0, 1, 0, 1, 0, 1, 0, 1,
        1, 0, 0, 0, 1, 0, 0, 0, 1,
        1, 1, 1, 1, 1, 1, 1, 1, 1
      ]
    },
    {
      "levelName": "Level_4",
      "width": 9,
      "height": 9,
      "startPosA": { "x": 1, "y": 7 },
      "startPosB": { "x": 7, "y": 1 },
      "finishPosA": { "x": 7, "y": 1 },
      "finishPosB": { "x": 1, "y": 7 },
      "enemyPositionsA": [ { "x": 4, "y": 4 } ],
      "enemyPositionsB": [ { "x": 4, "y": 4 } ],
      "mazeLayoutA": [
        1, 1, 1, 1, 1, 1, 1, 1, 1,
        1, 0, 0, 0, 1, 0, 0, 0, 1,
        1, 1, 1, 0, 1, 0, 1, 1, 1,
        1, 0, 0, 0, 0, 0, 0, 0, 1,
        1, 0, 1, 0, 0, 0, 1, 0, 1,
        1, 0, 0, 0, 0, 0, 0, 0, 1,
        1, 1, 1, 0, 1, 0, 1, 1, 1,
        1, 0, 0, 0, 1, 0, 0, 0, 1,
        1, 1, 1, 1, 1, 1, 1, 1, 1
      ],
      "mazeLayoutB": [
        1, 1, 1, 1, 1, 1, 1, 1, 1,
        1, 0, 0, 0, 0, 0, 0, 0, 1,
        1, 0, 1, 1, 1, 1, 1, 0, 1,
        1, 0, 1, 0, 0, 0, 1, 0, 1,
        1, 0, 1, 0, 0, 0, 1, 0, 1,
        1, 0, 1, 0, 0, 0, 1, 0, 1,
        1, 0, 1, 1, 1, 1, 1, 0, 1,
        1, 0, 0, 0, 0, 0, 0, 0, 1,
        1, 1, 1, 1, 1, 1, 1, 1, 1
      ]
    },
    {
      "levelName": "Level_5",
      "width": 10,
      "height": 10,
      "startPosA": { "x": 1, "y": 1 },
      "startPosB": { "x": 8, "y": 1 },
      "finishPosA": { "x": 8, "y": 8 },
      "finishPosB": { "x": 1, "y": 8 },
      "enemyPositionsA": [ { "x": 3, "y": 3 }, { "x": 6, "y": 6 } ],
      "enemyPositionsB": [ { "x": 4, "y": 4 } ],
      "mazeLayoutA": [
        1, 1, 1, 1, 1, 1, 1, 1, 1, 1,
        1, 0, 0, 0, 0, 0, 0, 0, 0, 1,
        1, 0, 1, 1, 1, 1, 0, 1, 0, 1,
        1, 0, 1, 0, 0, 0, 0, 1, 0, 1,
        1, 0, 1, 0, 0, 0, 0, 1, 0, 1,
        1, 0, 1, 0, 0, 0, 0, 0, 0, 1,
        1, 0, 0, 0, 1, 1, 1, 1, 0, 1,
        1, 1, 1, 0, 0, 0, 0, 1, 0, 1,
        1, 0, 0, 0, 1, 1, 0, 0, 0, 1,
        1, 1, 1, 1, 1, 1, 1, 1, 1, 1
      ],
      "mazeLayoutB": [
        1, 1, 1, 1, 1, 1, 1, 1, 1, 1,
        1, 0, 0, 0, 1, 0, 0, 0, 0, 1,
        1, 0, 1, 0, 1, 0, 1, 1, 0, 1,
        1, 0, 1, 0, 0, 0, 0, 1, 0, 1,
        1, 0, 1, 1, 1, 1, 0, 1, 0, 1,
        1, 0, 0, 0, 0, 1, 0, 0, 0, 1,
        1, 1, 1, 1, 0, 1, 1, 1, 1, 1,
        1, 0, 0, 0, 0, 0, 0, 0, 0, 1,
        1, 0, 1, 1, 1, 1, 1, 1, 0, 1,
        1, 1, 1, 1, 1, 1, 1, 1, 1, 1
      ]
    },
    {
      "levelName": "Level_6",
      "width": 10,
      "height": 10,
      "startPosA": { "x": 1, "y": 8 },
      "startPosB": { "x": 8, "y": 1 },
      "finishPosA": { "x": 8, "y": 1 },
      "finishPosB": { "x": 1, "y": 8 },
      "enemyPositionsA": [ { "x": 4, "y": 4 }, { "x": 5, "y": 5 } ],
      "enemyPositionsB": [ { "x": 3, "y": 6 }, { "x": 6, "y": 3 } ],
      "mazeLayoutA": [
        1, 1, 1, 1, 1, 1, 1, 1, 1, 1,
        1, 0, 0, 1, 0, 0, 0, 1, 0, 1,
        1, 0, 0, 1, 0, 1, 0, 1, 0, 1,
        1, 0, 0, 0, 0, 1, 0, 0, 0, 1,
        1, 1, 1, 1, 0, 0, 0, 0, 0, 1,
        1, 0, 0, 0, 0, 0, 0, 1, 0, 1,
        1, 0, 1, 1, 1, 1, 0, 1, 0, 1,
        1, 0, 0, 0, 0, 0, 0, 0, 0, 1,
        1, 1, 1, 0, 1, 1, 1, 1, 0, 1,
        1, 1, 1, 1, 1, 1, 1, 1, 1, 1
      ],
      "mazeLayoutB": [
        1, 1, 1, 1, 1, 1, 1, 1, 1, 1,
        1, 0, 0, 0, 0, 0, 0, 1, 0, 1,
        1, 0, 1, 1, 1, 1, 0, 1, 0, 1,
        1, 0, 1, 0, 0, 1, 0, 0, 0, 1,
        1, 0, 1, 0, 0, 1, 1, 1, 1, 1,
        1, 0, 0, 0, 0, 0, 0, 0, 0, 1,
        1, 1, 1, 1, 0, 1, 0, 1, 0, 1,
        1, 0, 0, 0, 0, 1, 0, 1, 0, 1,
        1, 0, 1, 1, 1, 1, 0, 0, 0, 1,
        1, 1, 1, 1, 1, 1, 1, 1, 1, 1
      ]
    },
    {
      "levelName": "Level_7",
      "width": 11,
      "height": 11,
      "startPosA": { "x": 1, "y": 1 },
      "startPosB": { "x": 9, "y": 9 },
      "finishPosA": { "x": 9, "y": 9 },
      "finishPosB": { "x": 1, "y": 1 },
      "enemyPositionsA": [ { "x": 5, "y": 5 }, { "x": 2, "y": 8 }, { "x": 8, "y": 2 } ],
      "enemyPositionsB": [ { "x": 5, "y": 5 }, { "x": 2, "y": 2 }, { "x": 8, "y": 8 } ],
      "mazeLayoutA": [
        1, 1, 1, 1, 1, 1, 1, 1, 1, 1, 1,
        1, 0, 0, 0, 0, 0, 0, 0, 0, 0, 1,
        1, 0, 1, 1, 1, 1, 1, 1, 1, 0, 1,
        1, 0, 1, 0, 0, 0, 0, 0, 1, 0, 1,
        1, 0, 1, 0, 1, 0, 1, 0, 1, 0, 1,
        1, 0, 1, 0, 0, 0, 0, 0, 1, 0, 1,
        1, 0, 1, 0, 1, 0, 1, 0, 1, 0, 1,
        1, 0, 1, 0, 0, 0, 0, 0, 1, 0, 1,
        1, 0, 1, 1, 1, 1, 1, 1, 1, 0, 1,
        1, 0, 0, 0, 0, 0, 0, 0, 0, 0, 1,
        1, 1, 1, 1, 1, 1, 1, 1, 1, 1, 1
      ],
      "mazeLayoutB": [
        1, 1, 1, 1, 1, 1, 1, 1, 1, 1, 1,
        1, 0, 0, 0, 0, 1, 0, 0, 0, 0, 1,
        1, 0, 1, 1, 0, 1, 0, 1, 1, 0, 1,
        1, 0, 0, 0, 0, 0, 0, 0, 0, 0, 1,
        1, 0, 1, 1, 1, 1, 1, 1, 1, 0, 1,
        1, 0, 0, 0, 0, 1, 0, 0, 0, 0, 1,
        1, 0, 1, 1, 1, 1, 1, 1, 1, 0, 1,
        1, 0, 0, 0, 0, 0, 0, 0, 0, 0, 1,
        1, 0, 1, 1, 0, 1, 0, 1, 1, 0, 1,
        1, 0, 0, 0, 0, 1, 0, 0, 0, 0, 1,
        1, 1, 1, 1, 1, 1, 1, 1, 1, 1, 1
      ]
    },
    {
      "levelName": "Level_8",
      "width": 11,
      "height": 11,
      "startPosA": { "x": 1, "y": 9 },
      "startPosB": { "x": 9, "y": 1 },
      "finishPosA": { "x": 9, "y": 1 },
      "finishPosB": { "x": 1, "y": 9 },
      "enemyPositionsA": [ { "x": 5, "y": 5 }, { "x": 3, "y": 3 }, { "x": 7, "y": 7 } ],
      "enemyPositionsB": [ { "x": 5, "y": 5 }, { "x": 3, "y": 7 }, { "x": 7, "y": 3 } ],
      "mazeLayoutA": [
        1, 1, 1, 1, 1, 1, 1, 1, 1, 1, 1,
        1, 0, 0, 0, 1, 0, 0, 0, 1, 0, 1,
        1, 0, 1, 0, 1, 0, 1, 0, 1, 0, 1,
        1, 0, 0, 0, 0, 0, 0, 0, 0, 0, 1,
        1, 1, 1, 0, 1, 1, 1, 0, 1, 1, 1,
        1, 0, 0, 0, 0, 0, 0, 0, 0, 0, 1,
        1, 1, 1, 0, 1, 1, 1, 0, 1, 1, 1,
        1, 0, 0, 0, 0, 0, 0, 0, 0, 0, 1,
        1, 0, 1, 0, 1, 0, 1, 0, 1, 0, 1,
        1, 0, 0, 0, 1, 0, 0, 0, 1, 0, 1,
        1, 1, 1, 1, 1, 1, 1, 1, 1, 1, 1
      ],
      "mazeLayoutB": [
        1, 1, 1, 1, 1, 1, 1, 1, 1, 1, 1,
        1, 0, 0, 0, 0, 0, 0, 0, 0, 0, 1,
        1, 0, 1, 1, 1, 0, 1, 1, 1, 0, 1,
        1, 0, 1, 0, 0, 0, 0, 0, 1, 0, 1,
        1, 0, 1, 0, 1, 1, 1, 0, 1, 0, 1,
        1, 0, 0, 0, 1, 0, 1, 0, 0, 0, 1,
        1, 0, 1, 0, 1, 1, 1, 0, 1, 0, 1,
        1, 0, 1, 0, 0, 0, 0, 0, 1, 0, 1,
        1, 0, 1, 1, 1, 0, 1, 1, 1, 0, 1,
        1, 0, 0, 0, 0, 0, 0, 0, 0, 0, 1,
        1, 1, 1, 1, 1, 1, 1, 1, 1, 1, 1
      ]
    },
    {
      "levelName": "Level_9",
      "width": 12,
      "height": 12,
      "startPosA": { "x": 1, "y": 1 },
      "startPosB": { "x": 10, "y": 10 },
      "finishPosA": { "x": 10, "y": 10 },
      "finishPosB": { "x": 1, "y": 1 },
      "enemyPositionsA": [ { "x": 3, "y": 3 }, { "x": 8, "y": 8 }, { "x": 3, "y": 8 }, { "x": 8, "y": 3 } ],
      "enemyPositionsB": [ { "x": 5, "y": 5 }, { "x": 6, "y": 6 }, { "x": 5, "y": 6 }, { "x": 6, "y": 5 } ],
      "mazeLayoutA": [
        1, 1, 1, 1, 1, 1, 1, 1, 1, 1, 1, 1,
        1, 0, 0, 0, 0, 0, 0, 0, 0, 0, 0, 1,
        1, 0, 1, 1, 1, 0, 0, 1, 1, 1, 0, 1,
        1, 0, 1, 0, 0, 0, 0, 0, 0, 1, 0, 1,
        1, 0, 1, 0, 1, 1, 1, 1, 0, 1, 0, 1,
        1, 0, 0, 0, 1, 0, 0, 1, 0, 0, 0, 1,
        1, 0, 0, 0, 1, 0, 0, 1, 0, 0, 0, 1,
        1, 0, 1, 0, 1, 1, 1, 1, 0, 1, 0, 1,
        1, 0, 1, 0, 0, 0, 0, 0, 0, 1, 0, 1,
        1, 0, 1, 1, 1, 0, 0, 1, 1, 1, 0, 1,
        1, 0, 0, 0, 0, 0, 0, 0, 0, 0, 0, 1,
        1, 1, 1, 1, 1, 1, 1, 1, 1, 1, 1, 1
      ],
      "mazeLayoutB": [
        1, 1, 1, 1, 1, 1, 1, 1, 1, 1, 1, 1,
        1, 0, 0, 0, 0, 0, 0, 0, 0, 0, 0, 1,
        1, 0, 1, 0, 1, 0, 1, 0, 1, 0, 1, 1,
        1, 0, 0, 0, 0, 0, 0, 0, 0, 0, 0, 1,
        1, 0, 1, 1, 1, 1, 1, 1, 1, 1, 0, 1,
        1, 0, 0, 0, 0, 0, 0, 0, 0, 0, 0, 1,
        1, 0, 1, 0, 1, 0, 0, 1, 0, 1, 0, 1,
        1, 0, 1, 0, 1, 0, 0, 1, 0, 1, 0, 1,
        1, 0, 0, 0, 0, 0, 0, 0, 0, 0, 0, 1,
        1, 1, 1, 1, 1, 1, 1, 1, 1, 1, 0, 1,
        1, 0, 0, 0, 0, 0, 0, 0, 0, 0, 0, 1,
        1, 1, 1, 1, 1, 1, 1, 1, 1, 1, 1, 1
      ]
    },
    {
      "levelName": "Level_10",
      "width": 12,
      "height": 12,
      "startPosA": { "x": 1, "y": 6 },
      "startPosB": { "x": 10, "y": 6 },
      "finishPosA": { "x": 10, "y": 6 },
      "finishPosB": { "x": 1, "y": 6 },
      "enemyPositionsA": [ { "x": 4, "y": 4 }, { "x": 7, "y": 7 }, { "x": 4, "y": 7 }, { "x": 7, "y": 4 } ],
      "enemyPositionsB": [ { "x": 2, "y": 2 }, { "x": 9, "y": 9 }, { "x": 2, "y": 9 }, { "x": 9, "y": 2 } ],
      "mazeLayoutA": [
        1, 1, 1, 1, 1, 1, 1, 1, 1, 1, 1, 1,
        1, 0, 0, 0, 1, 0, 0, 1, 0, 0, 0, 1,
        1, 0, 1, 0, 1, 0, 0, 1, 0, 1, 0, 1,
        1, 0, 0, 0, 0, 0, 0, 0, 0, 0, 0, 1,
        1, 1, 1, 0, 1, 1, 1, 1, 0, 1, 1, 1,
        1, 0, 0, 0, 1, 0, 0, 1, 0, 0, 0, 1,
        1, 0, 0, 0, 1, 0, 0, 1, 0, 0, 0, 1,
        1, 1, 1, 0, 1, 1, 1, 1, 0, 1, 1, 1,
        1, 0, 0, 0, 0, 0, 0, 0, 0, 0, 0, 1,
        1, 0, 1, 0, 1, 0, 0, 1, 0, 1, 0, 1,
        1, 0, 0, 0, 1, 0, 0, 1, 0, 0, 0, 1,
        1, 1, 1, 1, 1, 1, 1, 1, 1, 1, 1, 1
      ],
      "mazeLayoutB": [
        1, 1, 1, 1, 1, 1, 1, 1, 1, 1, 1, 1,
        1, 0, 0, 0, 0, 0, 0, 0, 0, 0, 0, 1,
        1, 0, 1, 1, 1, 1, 1, 1, 1, 1, 0, 1,
        1, 0, 1, 0, 0, 0, 0, 0, 0, 1, 0, 1,
        1, 0, 1, 0, 1, 1, 1, 1, 0, 1, 0, 1,
        1, 0, 1, 0, 1, 0, 0, 1, 0, 1, 0, 1,
        1, 0, 1, 0, 1, 0, 0, 1, 0, 1, 0, 1,
        1, 0, 1, 0, 1, 1, 1, 1, 0, 1, 0, 1,
        1, 0, 1, 0, 0, 0, 0, 0, 0, 1, 0, 1,
        1, 0, 1, 1, 1, 1, 1, 1, 1, 1, 0, 1,
        1, 0, 0, 0, 0, 0, 0, 0, 0, 0, 0, 1,
        1, 1, 1, 1, 1, 1, 1, 1, 1, 1, 1, 1
      ]
    }
  ]
}